###################################
###########                  # ####
############B############## ##  ###
####### ################### ##  ###
#######   ########        # ##  ###
#######                   # ##  ###
####################      # ##  ###
#                               ### 
####   ############  ##############
#####  ###           ##############
#A     ############################